1111111111111111111111111
1111111111111111111111111
1010011000000000000000001
100C000100001010000001101
1000000011111100000001101
1001110011100010110000001
10C110000C000000000000001
1000000111100001000010001
1000000111100001111111001
100000011110000100EP00001
1000000111100001000000001
1111111111111111111111111